%%%%%%%%%%
%P   % % %
%        %
%%      %%
%   G    %
%%      %%
%        %
%     G  %
%    % %.%
%%%%%%%%%%
