%%%%%%%%%%%%%%%%%%%%%%
%%% %%%%%%%%%%%%%%%%%% 
%%% %%%%%%%%%%%%%%%%%%
%P        G        G.%
%%%%%%%%%%%% %%%%%%%%%
%%%%%%%%%%%% %%%%%%%%%
%%%%%%%%%%%%%%%%%%%%%%