%%%%%%%%%%
%P       %        
% %%%%%% %
% %%%%%% %
% %%%%   %
% %%%%%% %
% %% %%% %
% %% %%% %
%      G.%
%%%%%%%%%%